1111111111111
1P00000000C11
100P011111001
100011E0000P1
1111111111111