1111111111111
1000000000011
10000111111x
1P0001E000001
1111111111111