111111111111
100000000001
101011111101
1P0000000E01
100000000C01
11111111111x