111111111111111111111111111111
10000C00011C000C00011000000001
1110K111011001111111100000K001
1C001000010C000C00011111100001
10P001011111111C1000000000C001
100C10000000000C10011111111101
1111010111111011100110001CK001
1000010100001K1000C1100E000001
1C0000011110101111111111111001
111011111111111111111C00K000K1
1000000000000C0000000000000001
111111111111111111111111111111