1111111111
1P000C0001
1000000C01
1111100001
100000C001
1000111101
1C00100001
100E000001
1111111CC1
1CKC000001
1000C00C01
1111111111