1111111111
1P00000001
1000000001
1111100001
100000C001
1000111101
1C00100001
100E000001
1111111001
1C00000001
1000000001
1111111111